111111111111111111111109000000000100001001100001110010001000201101100011111111111101101001000000000001011101001010101111100001100011000001000101011101001011101010101001101001000100010101111101000010101110000001100010010100000101101101000110110110100081111111111111111111111
111111111111111111111100000000100000000001120100110001010001001111111100113013101011100000001000111111001101111111090010004001100001000000010101101100111010111000001001110101410131110100011100101000100010101001141100801111011101101100001000000000000001111111111111111111111
111111111111111111111131010101010100000001100000100000101011101101110101110101000101100010006010101110101111010111010101010161100000001010001000001101111101016101011101101000101010001000101100010101009111610101111010100010101010101180010061310000000121111111111111111111111
111111111111111111111180310001010001010011111010100000100000401121010101010001010101101000100000100010101100111101010901010101110010000000100010001105014111111111111101101110000000003000001100011101010101010101111000010100010101001100004000000000000001111111111111111111111
111111111111111111111190400000000005000041101011111111111010101101010000300001010101101010111111101010101151010100000101010101104010101110101010101101010100810101010101101010111110101010101101010000000101000101101011110111101014101171000000000001340121111111111111111111111
111111111111111111111131900001000000000001100001001001111101101111101010001060101001100001000101000001011101111101101260101001141000111051111111001101010000000010001601101000111111010101051101010170001010101601101018111101010101501100000000001000100001111111111111111111111
111111111111111111111100060000090041000131106060611111101010101106060610000101000101106000611010100010001101111111010111110111100000011210600000001111110111010111111011105050511010100010001150505011110000111001105050511111110111001150500000008100000001111111111111111111111
111111111111111111111166666666666000000071160000000000050509661160111666666005550061160180000006550005061160101666606005050061160600000636550505551160666660606050550061160400000606005005001160666666606050010101160000000006500502051166666666666666616101111111111111111111111
111111111111111111111181120900000005000001100101111111111110001117100500050005000001100100005000500050001101111611111111111501160101000100010001001110100010001000100001106101111161111111111101100000000000000001101111111111115111001160005000000000000001111111111111111111111
111111111111111111111120050000500050000901105050505005005005051100050050005050000001155550505555055555001105005005000000000001105500555055555555551100005005005000000001100505055055055550501150005005005000050001100505550505550050551135000050005400500581111111111111111111111
111111111111111111111100001000100310000001191101010101110111101101400010100000500101100011115101111130001111010000180000101101100011110010110104101101000310621011110051101511100060010400101101000101111110100031101101100000100111101100000000010000000001111111111111111111111
111111111111111111111100050050103014050001101005050001000110111101111100011015100011101000011001010103011101011001001410110111101000101501010010001131610501011011111101100000101010000062101111110501011111111151100010101013100059001181000100000671000101111111111111111111111